610461046100000000-
070707070700000000-
070707070700000000-
070707070700000000-
070707070700000000-
070707070700000000-
036203620360000000-
000000000000000000
