000000000000000-
840078840078840-
090090090090090-
090090090090090-
090090090090090-
090090090090090-
090090090090090-
090090090090090-
068850068850068-
000000000000000
